1111111111111111111111
1P00000011111111000C11
101111101C000001010011
10100C1011111101010001
1010111010000001C10101
1010101000111111110111
1000000010000001000001
1111111010111111000001
1C000000100000000C0011
1011101011111111110111
10000000001000000000C1
1011111010111111010111
1010000000000C00010001
1C01011111001111111101
1010100000001000000001
1010111111011101110111
1000000001000000000001
1C000100000000000000E1
1111111111111111111111
