1111
1P01
1C01
1C01
1C01
1001
1C01
1001
1C01
1C01
1C01
1E01
1111
1001
1111
