111111111111111111111111111111111111111111111111111111
101101101101101101101101101101101101101101101101101101
1C00000000000000000000000000000000000000000000000000C1
111111111111111111111111111111111111111111111111111101
1C00000000000000000000000000000000000000000000000000C1
101111111111111111111111111011101110111011101110111011
1C00000000000000000000000P101C101C101C101C101C101C1001
101111111111111111111111111110111011101110111011101111
100000000000000000000000000000000000000000000000000001
111011011011011011011011011011011011011011011011011001
1E0000000000000000000000000000000000000000000000000001
111111111111111111111111111111111111111111111111111111