1111
1PA1
10C1
1A01
10E1
1111
