1111111111
1P00000001
10C01110C1
10001E1001
1011100001
101C011101
1000A100C1
111111A001
10001C0001
1111111111