1111111111111111111111111111111111111111111111111
1CA0AC1A000A11111A000A10000000000000000000ACA0001
100000100C00A111A00C0010000ACCCCCCCCCA000ACCCA001
1A000A100CC00A1A00CC001000000000ACA000000CCECC001
100000100CCC00100CCC001000000000ACCA000000CCC0001
1C000A10000000A000000010ACA000ACCCCCA00000ACA00A1
1PC000001111A000A1111000CAC00ACCCCCCCCCCCCA0A0AA1
1C000A10000000A000000010ACA000ACCCCCA00000ACA00A1
100000100CCC00100CCC001000000000ACCA000000CCC0001
1A000A100CC00A1A00CC001000000000ACA000000CCCCC001
100000100C00A111A00C0010000ACCCCCCCCCCA00ACCCA001
1CA0AC1A000A11111A000A10000000000000000000ACA0001
1111111111111111111111111111111111111111111111111