1111111111111
1A0A1C0A1A0C1
10C0000000001
10A010AC1CA01
1011111111101
10AC1C0A1A001
100000P01A001
1C0A1A0C1C0C1
1111111111011
1A0A1ACA1A0A1
1CC0000000C01
1ECA1ACA100A1
1111111111111