1111
1P01
1C01
1C01
1C01
1A01
1C01
1A01
1C01
1C01
1C01
1E01
1111
1A01
1111