1111
1P01
1C01
1A01
1C01
1A01
1C01
1A01
1C01
1A01
1C01
1E01
1C01
1AA1
1111