1111111111111111111111111
1C000C1C100000A0AA001CCC1
101110101C10101111101CEC1
101A10101110101000001CCC1
1010101000001010111110001
1C001010111110101000000C1
1111101010000010101111111
1C00001110111110000000001
10111000001000000A1111101
100C11111A101110101000001
1010100010101A10101011101
10101010101010101010100C1
1010101010101010101010111
10101010101C101010101C001
1010101010101010101011101
10100010101010101010100C1
101111101010101A1A1010111
101C00001010101010101C001
1010111110101011101011101
10101000001010000A10100C1
10101011111C1111111010111
10101A00000A0000000010001
1010111111111111111111101
1P10000000000000000000001
1111111111111111111111111