1111111111111111111111111111111111
1E0000A00000000C00000C000000000001
101A01001010101A1010A10101A10101A1
101001001A101010101001010101010101
1P0000000C00C0000000000A00000000C1
1111111111111111111111111111111111