1111111111111111111111111111111111111111111111111111111111
1P000000000010000000100000000010000000100000000000000C0001
1000000000010000000100000000000100000001000000000000CAC001
10000000C0100000001000000000000010000000100000C000000C0001
1000000CAC01000001000000111000000100000100000CAC0000000001
10000000C0001000010001111111110001000010000000C00000000001
1000000000000100010111111111111101000100C00000000000000001
100000000000001001011111111111110100100CAC0000000000000001
100000000000C001001111111111111110010000C0000000000C000001
100000C0000CAC001101111111111111011000000000000000CAC00001
10000CAC0000C00000001111111111100000000000000000000C000001
100000C00000000001110111111111011100000000C000000000000001
10000000000000010000101111111010000100000CAC00000000000001
1000C0000000001000010000111000010000100000C000000C00000001
100CAC000000000100100011111110001001000000000000CAC0000001
1000C00000000001000100110101100100010000000000000C00000001
10000000000C00001000100111110010001000000C0000000000C00001
1000000000CAC000010010001110001001000000CAC00000000CAC0001
10000000000C00000000100010100010000000000C0000000000C00001
1000000000000000000010000000001000000000000000000000000001
1000000000000000000000000000000000000000000000000000000001
1111111111111111111111111111111111111111111111111111111001
11111111111111111111111111111111111111111111111111111C1001
1C00000000000000000000000000000000000000000000000000000001
11AAAAAAAAAAAAAAAAAAAAAAAAAAAAAAAAAAAAAAAAAAAAAAAAAA101101
11AAAAAAAAAAAAAAAAAAAAAAAAAAAAAAAAAAAAAAAAAAAAAAAAAA1011C1
11AAAAAAAAAAAAAAAAAAAAAAAAAAAAAAAAAAAAAAAAAAAAAAAAAA101111
11AAAAAAAAAAAAAAAAAAAAAAAAAAAAAAAAAAAAAAAAAAAAAAAAAA101111
1C00000000000000000000000000000000000000000000000000000001
1111111111111111111111111111111111111111111111111111111001
111E000000000000000000000000000000000000000000000000000001
1111111111111111111111111111111111111111111111111111111111