111111111111111111111111111111111111111111111111111111
1011A11A11A11A11A11A11A11A11A11A11A11A11A11A11A11A11A1
1C00000000000000000000000000000000000000000000000000C1
111111111111111111111111111111111111111111111111111101
1C00000000000000000000000000000000000000000000000000C1
101111111111111111111111111011101110111011101110111011
1C00000000000000000000000P1A1C1A1C1A1C1A1C1A1C1A1C1A01
101111111111111111111111111110111011101110111011101111
100000000000000000000000000000000000000000000000000001
111A11A11A11A11A11A11A11A11A11A11A11A11A11A11A11A11A01
1E0000000000000000000000000000000000000000000000000001
111111111111111111111111111111111111111111111111111111